***********************************************************************
-     *     *       *   *     *     *       *       *   *   *   *   * *
***** * *** *** *** * * * *** * *** * ***** * *** * *** *** * *** * * *
*     * *   *   * *   * * *   *   * *     * * *   *     *     *   *   *
* ***** * *** *** ***** * * ******* ******* * *********** ***** ***** *
* *     *     *         * *   *   * *       *   *             * *   * *
* * ***** ***** ********* *** * * * * ********* * * ***** ***** * *** *
* * *     *     *         *   * *     *       * * * *   *   *   * *   *
* * ******* ***** ********* *** *** *** ***** * *** * * *** * *** * ***
* *   *     *   * *   *   * *     *     *   * *   * * * *     * *   * *
* *** * ***** * * * *** * * * *** ********* * *** * * * * * *** ***** *
* *   *       *   *   * *   * *   *       *   *   * * * * *   * *   * *
* * *************** * * ******* *** ***** ***** *** *** * *** * * * * *
*   *               *   *   *   *     *           * *   * *   *   *   *
***** ***************** * * * ******* * ******* * * * *** * ******* ***
*       *     *   *     * *   *   *   *     *   *   *     *       *   *
* ***** * *** * * * ***** ***** * * ***** * * ********* ********* *** *
* *   *   * * * * * *   * *     *   *     * * *   *   * *     * *   * *
* * * ***** * * * * *   * * * ******* * ***** * * * * * * *** * *** * *
*   *   *   * * * * *   * * *     *   * *   * * * * *   * *   * *   * *
******* *** *           * ***** *** ***** * * *** * ***** * *** * *** *
*   *     * * * * * * * *   * *   * *     *   *   * * *   *       *   *
* * *** * * * * * * * ***** * *** * * ********* *** * * ******* *** ***
* *     * * *   * *   *     * *   * * *         *   *   *     * *     *
* ******* * ***** ***** ***** * *** * * * ***** * *********** * * *** *
* *     *   *   * *         * *   * *   * *   * *       *     * *   * *
* ***** ***** *** * *** *** * *** * ***** * * * * ***** * *** * * * ***
*   * * *     *   *   * *   *     *   *   * * * * *   *   *   *   *   *
*** * * * ***** ******* * *********** * *** * *** * ***************** *
*   *         *     *   * *       *   * *   * *   * *   *   * *     * *
* ******* ********* * *** * ***** * *** ***** * *** * * * * * * *** * *
* *         *       * *   * *     * *   *   * * *   * * * *   *   * * *
* * ******* * ******* * *** * ***** * *** * * * * * *** * *** *** * * *
*   *       *         *     *       *     *   *   *     *   *     *   o
***********************************************************************